[
  {
    "type": "mapgen",
    "weight": { "global_val": "vanilla_lake_weight", "default": 100000 },
    "om_terrain": "lake_bed",
    "object": {
      "fill_ter": "t_lake_bed",
      "rows": [
        "                        ",
        "                        ",
        "                        ",
        "         wer            ",
        "        78889           ",
        "        Rh.hT           ",
        "        4QBQ6           ",
        "        A...A           ",
        "       f4h,h6z          ",
        "       d4h,h6x          ",
        "       d[h,h]x          ",
        "       d4h,h6x          ",
        "       d[=.=]x          ",
        "       d4=.=6x          ",
        "       d[...]x          ",
        "       d4...6x          ",
        "       d[...]x          ",
        "       s4...6c          ",
        "        4...6           ",
        "        1BBB3           ",
        "                        ",
        "                        ",
        "                        ",
        "                        "
      ],
      "terrain": {
        "7": "t_sunkenheli_windshield_nw",
        "9": "t_sunkenheli_windshield_ne",
        "8": "t_sunkenheli_windshield_n",
        "R": "t_sunkenheli_windshield_w",
        "T": "t_sunkenheli_windshield_e",
        "1": "t_sunkenheli_wall_swcorner",
        "3": "t_sunkenheli_wall_secorner",
        "Q": "t_sunkenheli_wall_n",
        "2": "t_sunkenheli_wall_s",
        "4": "t_sunkenheli_wall_w",
        "6": "t_sunkenheli_wall_e",
        "w": "t_sunkenheli_quarterpanel_n_left",
        "e": "t_sunkenheli_quarterpanel_n_middle",
        "r": "t_sunkenheli_quarterpanel_n_right",
        "s": "t_sunkenheli_quarterpanel_w_left",
        "d": "t_sunkenheli_quarterpanel_w_middle",
        "f": "t_sunkenheli_quarterpanel_w_right",
        "z": "t_sunkenheli_quarterpanel_e_left",
        "x": "t_sunkenheli_quarterpanel_e_middle",
        "c": "t_sunkenheli_quarterpanel_e_right",
        "A": "t_sunkenheli_door_horizontal",
        "B": "t_sunkenheli_door_vertical",
        "[": "t_sunkenheli_window_w",
        "]": "t_sunkenheli_window_e",
        ".": "t_sunkenheli_floor",
        ",": "t_sunkenheli_floor_rotator",
        "h": "t_sunkenheli_floor"
      },
      "furniture": { "h": "f_sunkenheli_seat_rotating", "=": "f_crate_c", " ": [ [ "f_region_lake_bed", 1 ], [ "f_null", 199 ] ] }
    }
  }
]
